Test cave game
An Interactive Fiction by superMDguy
Release 1 / Serial number 161104 / Inform 7 build 6M62 (I6/v6.33 lib 6/12N) SD

Random tunnel2
You are in a dim tunnel.  Stalactites protrude from the walls.  The ground has gravel on it.

>west
Random cave chamber31
You are in a dim room.  You see a huge vaulted ceiling above you.  It's beautiful.

>up
Random tunnel6
You are in a dim tunnel.  Stalactites protrude from the walls.  The ground has gravel on it.

>east
Random cave chamber21
You are in a dim room.  You see a huge vaulted ceiling above you.  It's beautiful.

>east
Random cave chamber21
You are in a dim room.  You see a huge vaulted ceiling above you.  It's beautiful.

>e
Random cave chamber21
You are in a dim room.  You see a huge vaulted ceiling above you.  It's beautiful.

>e
Random cave chamber21
You are in a dim room.  You see a huge vaulted ceiling above you.  It's beautiful.

>u
Random tunnel6
You are in a dim tunnel.  Stalactites protrude from the walls.  The ground has gravel on it.

>u
Random tunnel6
You are in a dim tunnel.  Stalactites protrude from the walls.  The ground has gravel on it.

I beg your pardon?

>u
Random tunnel6
You are in a dim tunnel.  Stalactites protrude from the walls.  The ground has gravel on it.

>w
Random cave chamber31
You are in a dim room.  You see a huge vaulted ceiling above you.  It's beautiful.

>w
Random cave chamber31
You are in a dim room.  You see a huge vaulted ceiling above you.  It's beautiful.

>e
Random cave chamber21
You are in a dim room.  You see a huge vaulted ceiling above you.  It's beautiful.

I beg your pardon?

>e
Random cave chamber21
You are in a dim room.  You see a huge vaulted ceiling above you.  It's beautiful.

>s
Random tunnel26
You are in a dim tunnel.  Stalactites protrude from the walls.  The ground has gravel on it.

>s
Random tunnel26
You are in a dim tunnel.  Stalactites protrude from the walls.  The ground has gravel on it.

>n
Random tunnel16
You are in a dim tunnel.  Stalactites protrude from the walls.  The ground has gravel on it.

>n
Random tunnel16
You are in a dim tunnel.  Stalactites protrude from the walls.  The ground has gravel on it.